100 108 108 108 108 108 100 100 100 108 108 108 108 108 100 100 100 100 100 100 5 13 13 21
61  61  61  61  61  61  69  69  61  61  61  61  61  61  69  69  69  69  69  69  77  85  85  93
61 109 61 61 61 61 61 61 61 109 61 61 61 61 61 61 61 61 109 109 6 14 85 21
109 30 109 109 109 109 109 109 109 30 109 109 109 109 109 109 109 109 30 0 6 14 85 93
62 70 78 62 62 78 62 78 62 70 78 62 62 78 62 78 78 86 70 94 102 110 7 0
