8 16 24 8 8 16 24 8 8 16 32 8 8 16 24 8 40 16 24 40 8 8 8 8 16 24 48 16 56 8 8 40 16 40 16 40 16 40 16 8 40 8 56 56 8 48 16 64 72 80 80 16 80 80 80 80
17 25 33 41 49 25 33 41 49 25 57 41 49 25 33 41 17 25 33 65 49 49 49 49 25 73 65 25 49 49 49 17 25 65 25 65 25 65 25 49 65 49 49 49 49 65 25 81 89 97 105 2 105 10 10 10
49 25 73 65 49 25 33 65 49 25 33 65 49 25 33 65 49 25 33 65 49 49 50 58 66 74 82 82 90 98 49 49 25 65 25 65 25 65 25 41 65 49 50 58 82 74 66 106 3 11 11 66 105 105 19 19
49 25 49 65 49 25 73 65 41 25 33 65 49 25 73 65 49 25 33 65 50 58 27 35 25 49 17 25 43 51 74 82 25 65 25 65 25 65 25 17 65 50 67 35 49 49 18 42 75 19 19 25 11 83 91 105
49 25 49 65 49 25 49 65 17 25 73 65 49 25 49 65 17 25 73 50 67 35 41 49 25 49 49 25 49 25 41 41 25 65 25 65 25 65 25 41 50 67 35 41 49 49 25 42 75 105 105 2 19 25 101 91
74 66 74 74 74 66 74 74 74 66 74 74 74 66 74 74 74 66 74 27 74 74 74 74 66 74 74 66 74 66 74 74 66 74 66 74 66 74 66 74 27 74 74 74 74 74 66 44 75 60 11 66 11 66 68 76
