64 72 80 80 16 80 80 80 80 88 80 88 80 80 80 80 96  
81 89 97 105 2 105 10 10 10 2 97 25 105 105 10 10 81  
106 3 11 11 66 105 105 19 19 25 19 25 105 97 11 11 106 
42 75 19 19 25 11 83 91 105 99 99 107 11 83 91 97 4
42 75 105 105 2 19 25 101 91 99 99 2 19 25 101 91 4
44 75 60 11 66 11 66 68 76 99 99 66 60 66 68 76 92 
