29 37 45 29 0 0 29 0 29 0 16 37 45 0 16 53  
25 105 101 2 0 0 2 0 25 0 25 105 101 45 25 4  
2 105 105 107 0 0 2 0 25 0 25 105 105 101 25 4 
107 38 38 107 46 38 107 0 107 0 107 38 38 38 107 4
2 0 0 2 15 23 25 31 25 31 25 23 31 0 25 38
55 55 55 55 55 55 55 55 55 55 55 55 55 55 107 55
