8 8 16 56 8 16 40 8 16 24 104 1 8 9 16 1 8 9 16 1 8 32 40 64
49 17 25 49 49 25 65 49 25 33 17 49 18 26 25 34 18 26 25 34 18 57 65 42
74 82 82 90 98 25 65 49 25 73 49 49 25 49 25 49 25 49 25 41 25 73 65 81
57 49 18 43 51 82 74 82 82 90 98 49 25 49 25 49 25 49 25 17 25 50 58 106
73 49 25 49 41 25 17 25 17 43 28 98 25 49 25 49 25 49 25 49 25 27 35 42 
74 74 66 74 74 66 74 66 74 74 74 51 66 74 66 74 66 74 66 74 66 74 74 44
